00000000000000000000-
00000000000000000000-
00000000000000000000-
00001111110000000000-
11111000010000000000-
00000000011111000000-
00000000000001000000-
00000000000001111111-
00000000000000000000-
00000000000000000000