00000000000000000000-
00000000000000000000-
00000000000000000000-
00001111111111110000-
11111000010000011000-
00001000011111001000-
00001000000001001000-
00001000000001111111-
00001000000000000100-
00001111111111111100